# script	roman
А	a
Б	b
В	v
Г	g
Д	d
Е	e
Ё	yo
Ж	zh
З	z
И	i
Й	y
К	k
Л	l
М	m
Н	n
О	o
П	p
Р	r
С	s
Т	t
У	u
Ф	f
Х	kh
Ц	ts
Ч	ch
Ш	sh
Щ	shch
Ы	y
Э	e
Ю	yu
Я	ya
Ь	
Ъ	

# Kazakh / Mongolian Cyrillic (subset)
Ә	a
Ғ	gh
Қ	q
Ң	ng
Ө	o
Ұ	u
Ү	u
Һ	h
І	i
